NO            ./textuer/moon.xpm

SO                     ./textuer/w_moon.xpm

WE     ./textuer/cloud.xpm

EA      ./textuer/lace.xpm

F 202,166,252
C 135,206,255


11111111111111111111
10000000000000000001
10000000000000000001
10000000000000000001      11111111
10000000000000000001      10000001
10000000000000000001      1N000001
10000000000000000001      10000001
10000000000N00000001      11111111
10000000000000000001
10000000000000000001
10000000000000000001
11111111111111111111